17,16,
#################
#           #####
#           #   #
#               #
#           #   #
#           #####
#######     #####
#######     #####
#######     #####
#######     #####
#######     #####
#######     #####
#######     #####
#######     #####
#######     #####
#################
KeyDoor,12,3,PURPLE,3,3,
LineEnemy,8,9,1,
Player,9,4,2,
FireBoots,9,12,
Fire,6,1,
Fire,6,2,
Fire,6,3,
Fire,6,4,
Fire,6,5,
Goal,14,3,
Inventory,