8,16,
########
#    ###
#    ###
#    ###
#    ###
########
########
#      #
#      #
#  ##  #
#  ##  #
#      #
# #    #
# #    #
#      #
########
Player,1,7,0,
Goal,2,2,
DumbEnemy,3,12,0,
Teleporter,5,13,4,4,